000000000000000000000000000000
000000000000000000000000000000
000000000000000000000000000000
000000000000000000000000000000
000000000000000000000000000000
000000000000000000000000000000
000000000000000000000000000000
000000000000000000000000000000
000000000000000000000000000000
000000000000000000000000000000
000000111111111111111111110000
000002120202222220202020210000
000011100002300020000200110000
000012100002000020021000210000
000012100002000020021220210000
000012100002000020021000210000
000011100002222220000200110000
000011100000000000000000010000
000021111111111111111111120000
000001222222222222222222100000
000001111111111111111111100000
000000000000000000000000000000
000000000000000000000000000000
000000000000000000000000000000
000000000000000000000000000000
000000000000000000000000000000
000000000000000000000000000000
000000000000000000000000000000
000000000000000000000000000000
000000000000000000000000000000