000000000000000000000000000000
000000000000000000000000000000
000000000000000000000000000000
000000000000000000000000000000
000000000000000000000000000000
000000000000000000000000000000
000000000000000000000000000000
000000000000000000000000000000
000000000000000000000000000000
000000000000000000000000000000
000000000111111111111000000000
000000000120004000021000000000
000000000100000000001000000000
000000000100030000001000000000
000000000100000000001000000000
000000000140000000041000000000
000000000100000000001000000000
000000000100000000001000000000
000000000100000000001000000000
000000000120004000021000000000
000000000111111111111000000000
000000000000000000000000000000
000000000000000000000000000000
000000000000000000000000000000
000000000000000000000000000000
000000000000000000000000000000
000000000000000000000000000000
000000000000000000000000000000
000000000000000000000000000000
000000000000000000000000000000