000000000000000000000000000000
000000000000000000000000000000
000000000000000000000000000000
000000000000000000000000000000
000000000000000000000000000000
000000000000000000000000000000
000000000000000000000000000000
000000000000000000000000000000
000000000000000000000000000000
000000000000000000000000000000
000001111111111111111111100000
000021202022222202020202120000
000111000023000200000000111000
000121000020000200210000121000
000121000020000200210000121000
000121000020000200210000121000
000111000022222200000000111000
000111000000000000000000111000
000021111111111111111111120000
000001222222222222222222100000
000001111111111111111111100000
000000000000000000000000000000
000000000000000000000000000000
000000000000000000000000000000
000000000000000000000000000000
000000000000000000000000000000
000000000000000000000000000000
000000000000000000000000000000
000000000000000000000000000000
000000000000000000000000000000