000000000000000000000000000000
000000000000000000000000000000
000000000000000000000000000000
000000000000000000000000000000
000000000000000000000000000000
000000000000000000000000000000
000000000000000000000000000000
000000000000000000000000000000
000000000000000000000000000000
000000000000000000000000000000
000000000111111111111000000000
000000000120002000021000000000
000000000100000000001000000000
000000000100030000001000000000
000000000100000000001000000000
000000000120000000021000000000
000000000100000000001000000000
000000000100000000001000000000
000000000100000000001000000000
000000000120002000021000000000
000000000111111111111000000000
000000000000000000000000000000
000000000000000000000000000000
000000000000000000000000000000
000000000000000000000000000000
000000000000000000000000000000
000000000000000000000000000000
000000000000000000000000000000
000000000000000000000000000000
000000000000000000000000000000