000000000000000000000000000000
			000000000000000000000000000000
			000000000000000000000000000000
			000000000000000000000000000000
			000000000000000000000000000000
			000000000000111111000000000000
			000000000000102201000000000000
			000000000000100001000000000000
			000000000111111111111000000000
			000000000121212121211000000000
			000000002102020202021200000000
			000000111100000000001111000000
			000000120100000000001021000000
			000000100100003000001001000000
			000000120120000000021021000000
			000000100100000000001021000000
			000000120100000000001001000000
			000000111100000000001111000000
			000000002100000000001200000000
			000000000120002000021000000000
			000000000111111111111000000000
			000000000000122221000000000000
			000000000000122221000000000000
			000000000000111111000000000000
			000000000000000000000000000000
			000000000000000000000000000000
			000000000000000000000000000000
			000000000000000000000000000000
			000000000000000000000000000000
			000000000000000000000000000000