000000000000000000000000000000
000000000000000000000000000000
000000000000000000000000000000
000000000000000000000000000000
000000000000000000000000000000
000000000000000000000000000000
000000000000000000000000000000
000000000000000000000000000000
000000000002111200000000000000
000000000001202100000000000000
000000001111111111110000000000
000000001020202022210000000000
000000001200000000210000000000
000002111000030000011120000000
000001201200000000210210000000
000001001000000000010010000000
000001201200000000210210000000
000002111200000000011120000000
000000001220202020210000000000
000000001111111111110000000000
000000000001202100000000000000
000000000002111200000000000000
000000000000000000000000000000
000000000000000000000000000000
000000000000000000000000000000
000000000000000000000000000000
000000000000000000000000000000
000000000000000000000000000000
000000000000000000000000000000
000000000000000000000000000000