000000000000000000000000000000
000000000000000000000000000000
000000000000000000000000000000
000000000000000000000000000000
000000000000000000000000000000
000000000000000000000000000000
000000000000000000000000000000
000000000000000000000000000000
000000010010010010010000000000
000000000000000000000000000000
000001001111111111110010000000
000000001222222222210000000000
000000001200300000210000000000
000001111200000000011110000000
000001111200000000211210000000
000001111200000000012110000000
000001111200000000211210000000
000001111200000000211110000000
000000001200202022210000000000
000001001111111111110010000000
000000000001202100000000000000
000000010101111101010000000000
000000000000000000000000000000
000000000000000000000000000000
000000000000000000000000000000
000000000000000000000000000000
000000000000000000000000000000
000000000000000000000000000000
000000000000000000000000000000
000000000000000000000000000000